44 32 32 40 56 36 56 52
52 28 28 44 56 20 36 16
4 32 56 44 32 8 0 16
20 20 44 50 4 48 20 20
20 12 56 21 28 12 8 24
4 40 40 0 32 56 52 52
4 48 44 24 12 40 8 16
28 12 56 60 60 60 60 28
