36 56 44 56 52 52 44 56
4 56 52 60 20 20 52 52
28 52 4 50 12 24 28 20
36 16 20 4 48 36 56 28
4 24 4 0 17 28 52 60
12 32 0 24 12 48 4 56
36 16 28 52 44 8 8 48
28 12 56 28 60 44 40 24
