36 40 40 40 48 36 32 56
28 60 36 40 0 0 16 52
52 52 20 60 12 8 0 24
12 24 12 42 33 56 20 52
44 40 48 60 20 60 28 28
52 60 20 52 28 44 40 48
28 52 4 24 60 52 60 20
44 24 28 60 60 28 44 24
