60 36 56 52 44 40 32 48
52 12 40 8 40 48 12 24
4 56 46 32 56 4 48 52
12 48 60 29 44 8 24 28
44 8 40 32 48 60 36 48
44 32 48 4 24 52 12 24
60 4 8 16 36 24 44 48
44 24 44 24 28 44 40 24
