36 40 32 40 40 48 44 56
28 60 6 48 44 0 40 48
52 36 24 4 48 28 60 20
12 16 52 4 25 44 56 20
52 20 4 16 52 44 40 24
28 28 4 0 0 48 44 56
44 32 0 0 0 16 44 56
60 28 28 12 24 12 40 56
