52 44 56 36 56 36 48 52
12 56 36 8 32 8 8 24
44 32 8 32 8 48 60 60
44 0 56 23 52 20 60 52
60 4 56 28 12 8 56 20
36 24 60 52 44 40 40 16
28 36 48 12 48 60 44 24
60 12 8 56 28 44 40 56
