60 52 52 52 52 44 40 48
44 0 24 28 28 60 36 16
60 20 60 38 32 32 16 28
60 20 52 20 29 12 0 48
60 20 4 24 44 48 20 20
52 12 8 32 32 16 12 16
4 56 52 28 20 12 40 24
28 44 8 40 8 40 56 60
