36 56 52 60 44 48 60 52
12 48 28 44 56 12 48 28
52 12 32 48 60 44 0 56
20 36 0 27 44 32 24 52
28 20 28 52 52 20 60 28
44 8 48 12 16 12 32 48
44 32 0 32 24 60 28 20
60 12 8 8 40 40 40 24
