44 48 36 56 60 60 60 52
44 24 28 44 32 32 40 24
52 44 40 40 8 8 40 48
12 32 48 46 32 56 52 20
44 16 4 33 16 36 8 16
52 4 8 24 12 16 36 24
20 12 48 60 44 16 20 52
12 40 8 56 44 24 28 28
