36 32 32 48 52 44 56 52
4 8 16 12 0 56 44 24
20 52 12 56 28 36 48 52
28 20 46 49 52 12 24 20
60 20 44 24 4 48 36 16
60 4 56 60 20 28 28 28
52 4 32 48 4 56 52 60
12 24 28 12 8 40 8 56
