36 40 56 36 40 56 44 48
4 40 56 4 40 56 44 16
4 40 56 4 32 48 52 20
28 46 48 20 20 28 4 24
44 48 4 17 4 56 28 52
44 0 16 4 16 60 36 16
60 4 24 12 0 32 8 16
60 28 44 40 24 28 44 24
