44 40 32 56 44 48 44 56
52 60 12 56 60 12 48 60
28 36 40 56 36 56 4 56
60 28 44 59 20 60 4 48
44 56 60 52 4 56 28 28
52 36 48 28 20 60 60 60
12 16 20 60 4 56 52 52
60 12 8 40 24 60 12 24
