36 40 40 40 56 60 60 52
12 48 36 56 44 48 60 20
60 20 12 32 48 28 52 28
44 24 38 17 20 52 28 60
36 32 0 24 20 4 56 60
28 4 24 44 24 28 44 48
60 4 48 44 48 36 32 24
60 12 24 44 8 8 8 56
