60 36 48 60 36 40 56 60
36 0 0 40 24 44 48 52
12 8 16 44 40 32 16 20
60 52 4 34 32 0 16 20
60 12 24 4 25 28 28 28
36 48 60 4 48 36 48 52
4 24 44 24 20 4 16 28
28 60 44 40 24 28 12 56
