44 56 52 44 32 56 52 52
60 36 8 40 16 52 12 24
36 0 42 32 16 28 52 60
28 20 52 5 16 52 4 56
52 20 20 20 12 0 0 56
28 20 20 20 44 8 8 56
60 28 4 8 32 56 36 48
44 40 24 44 8 40 24 28
