44 40 48 52 60 60 52 52
36 56 4 0 56 44 0 16
28 44 8 0 56 44 0 24
60 44 40 27 36 48 4 48
36 56 36 56 4 8 0 16
12 48 12 40 24 36 0 16
60 28 44 48 52 20 4 24
44 40 56 28 12 24 28 60
