36 48 52 44 32 32 48 52
12 0 8 40 0 8 24 28
36 0 48 38 16 60 52 60
20 4 8 1 0 56 20 52
20 20 60 28 28 52 12 16
28 12 32 40 48 28 36 16
60 44 8 32 0 32 24 20
44 56 60 12 24 28 60 28
