44 56 44 56 36 32 32 56
52 52 60 60 28 12 8 48
28 12 34 40 32 32 48 20
36 56 4 32 16 28 20 20
4 32 24 21 4 40 16 28
12 24 52 20 12 48 12 56
60 44 16 28 44 16 60 60
44 56 28 44 40 24 60 60
