52 36 40 40 48 44 40 56
4 24 60 60 12 40 56 52
20 44 48 46 32 48 60 28
20 44 16 44 1 0 48 52
28 60 28 52 4 0 0 24
60 44 32 8 8 16 28 60
52 36 16 44 56 4 40 56
28 12 8 56 60 12 40 56
