44 40 40 48 44 32 48 52
52 60 44 0 56 20 12 24
20 52 60 20 36 16 52 60
28 20 44 19 12 24 28 60
44 24 44 0 32 40 48 60
60 60 44 24 28 52 12 48
36 48 52 36 56 20 44 24
28 12 24 28 60 28 60 60
