52 60 44 32 40 48 44 48
4 40 32 8 56 12 40 24
20 60 20 38 56 44 56 52
28 44 16 5 40 56 44 16
52 52 28 4 32 48 52 28
12 0 32 16 12 0 0 48
44 0 8 24 36 24 28 28
44 8 40 56 28 44 40 56
