44 32 32 40 48 36 56 60
36 24 28 52 28 20 52 52
12 40 40 8 56 20 4 16
44 32 32 42 48 12 8 16
36 24 4 56 4 57 60 20
20 44 8 56 4 48 52 28
12 40 40 48 20 20 4 48
44 56 60 28 28 28 28 28
