36 32 56 60 36 56 52 52
12 8 40 48 4 40 8 24
36 42 32 8 16 60 52 60
12 56 4 33 16 60 20 60
52 60 4 16 28 36 0 48
12 48 12 0 32 8 24 28
60 28 60 4 16 44 40 48
44 40 40 8 8 56 60 28
