52 44 48 60 60 52 36 48
28 36 24 60 44 0 24 20
36 24 44 50 60 28 36 24
4 48 52 29 60 60 20 60
4 8 24 60 44 32 24 60
12 48 44 48 52 20 36 56
36 8 40 0 0 8 8 56
28 44 40 24 12 56 44 56
