60 52 52 60 36 40 40 56
36 16 20 60 20 52 52 52
20 20 12 40 16 4 24 28
12 8 42 32 8 0 56 60
60 52 60 21 44 0 48 52
52 28 36 0 56 12 16 20
12 56 28 12 48 36 0 24
44 40 56 60 12 24 12 56
