60 52 60 44 48 36 40 48
44 24 60 44 0 0 56 28
52 52 44 56 12 16 60 52
28 12 42 48 36 0 40 24
52 44 40 9 8 16 36 56
28 36 40 32 48 12 24 60
60 20 52 28 20 36 32 48
44 8 8 56 12 8 8 24
