52 60 52 44 48 52 60 60
20 52 4 40 24 20 52 52
12 0 16 52 44 0 16 20
44 16 6 25 60 12 8 24
44 16 4 32 40 56 52 60
44 0 8 24 36 32 24 60
36 16 36 40 8 0 48 60
12 24 12 40 56 12 24 60
