60 44 32 48 60 44 48 60
36 56 28 28 52 60 20 60
28 36 40 56 12 40 16 60
44 24 38 32 40 40 16 52
36 48 28 4 49 36 8 16
28 20 60 4 16 28 60 28
60 20 60 12 16 52 52 60
60 12 40 56 28 28 12 56
