60 52 36 56 36 56 36 48
52 20 28 52 20 60 20 20
20 28 44 24 20 52 28 28
12 40 40 42 9 0 48 52
44 40 32 40 56 20 12 16
60 44 0 40 48 28 60 28
60 60 12 40 8 48 44 48
44 40 40 40 40 8 56 28
