60 36 56 60 44 56 36 48
44 24 60 36 32 56 20 20
44 32 40 0 8 56 4 24
36 8 56 31 60 60 12 48
20 52 60 52 36 32 32 16
28 12 56 28 12 24 20 20
36 40 48 44 32 56 20 28
12 56 28 44 24 60 12 56
