44 48 60 60 60 52 44 56
60 20 60 36 56 28 44 56
60 20 52 20 60 44 56 60
36 16 12 3 48 44 48 60
4 8 32 8 8 48 20 52
28 52 20 36 48 12 8 16
52 20 20 12 24 52 60 28
12 8 8 56 44 8 40 56
