60 36 56 52 60 44 32 48
60 12 40 8 48 36 24 28
60 60 52 54 4 16 36 56
52 60 20 29 20 20 12 48
4 32 8 32 8 16 60 20
12 8 32 0 48 12 32 16
36 48 20 4 16 36 24 28
12 24 28 12 8 24 44 56
