52 52 60 44 48 36 40 48
12 16 52 60 12 16 52 28
36 8 8 40 48 20 12 56
28 36 42 57 20 12 32 48
44 0 32 40 16 60 28 28
36 24 28 44 24 36 32 56
20 52 52 44 48 20 12 56
28 28 12 56 12 8 40 56
