36 40 40 32 40 48 52 60
4 40 40 0 48 20 20 52
20 60 60 4 24 4 16 20
12 56 54 4 32 8 16 28
44 56 4 8 17 44 16 60
44 48 20 60 4 32 8 56
60 28 4 48 28 28 52 60
44 56 12 24 60 60 28 60
