52 44 40 32 48 44 32 56
4 48 44 16 20 60 28 52
12 24 60 20 4 56 60 20
44 56 38 16 4 48 36 16
44 48 4 17 28 4 16 20
36 24 12 16 44 8 0 16
4 40 48 12 32 32 0 24
28 44 24 60 28 28 28 60
