44 48 52 36 32 56 52 52
36 8 8 8 24 60 28 20
28 36 34 56 52 36 56 28
44 16 4 32 16 20 60 60
44 8 16 21 12 8 56 60
52 44 24 28 36 48 52 52
12 32 56 60 28 28 28 28
44 24 44 40 40 56 60 60
