52 52 60 52 44 32 48 60
4 0 48 4 48 12 8 56
20 12 24 22 4 48 60 52
12 56 44 8 24 5 56 20
44 56 52 44 40 16 44 16
36 40 0 56 60 4 48 28
4 56 28 36 32 24 28 52
12 40 40 24 28 44 56 28
