36 48 60 44 32 56 36 56
12 0 56 60 20 36 8 48
44 16 60 60 12 16 52 20
36 24 38 40 48 12 16 28
12 56 4 33 16 52 4 48
44 56 12 0 24 28 4 16
60 52 60 20 60 60 28 28
44 24 60 28 44 40 40 56
