60 60 36 56 52 36 48 60
52 36 16 36 8 8 24 52
12 0 24 6 48 52 36 16
60 28 52 4 17 28 12 16
36 40 8 24 20 36 56 28
20 44 32 40 0 0 40 56
12 48 28 52 12 8 40 48
60 28 60 28 44 40 40 24
