44 56 36 32 40 40 40 48
52 36 16 4 48 52 60 20
20 4 8 24 20 20 36 16
28 12 56 46 9 16 28 20
60 52 36 40 32 24 60 28
44 16 28 52 20 52 36 56
44 0 32 16 4 16 12 56
60 12 8 8 24 12 56 60
