44 56 44 48 44 40 32 48
36 40 32 16 44 48 12 24
4 32 24 4 32 8 40 56
20 4 34 16 12 56 36 48
12 24 4 9 56 60 4 16
44 56 12 32 48 36 24 28
60 36 40 0 8 16 36 48
60 28 44 24 60 28 28 28
