36 40 40 56 44 32 56 60
28 44 32 56 36 8 48 60
60 52 20 44 24 60 12 48
44 16 12 50 52 44 48 28
52 28 60 5 8 48 20 60
12 56 60 20 60 20 4 48
60 44 40 0 32 16 12 16
60 60 44 24 12 8 56 28
