60 44 56 60 52 52 44 56
44 32 48 44 16 20 52 52
52 12 0 50 20 4 24 28
20 36 24 4 17 4 56 60
4 16 60 12 0 16 52 52
20 12 56 36 8 0 0 16
20 60 36 24 44 24 4 16
28 60 28 60 44 56 12 24
