36 32 56 44 48 44 32 56
4 24 44 48 28 60 28 52
12 48 36 8 48 52 60 28
36 0 16 54 12 8 56 60
20 12 24 21 52 36 48 52
28 52 44 0 0 16 28 28
44 24 52 12 0 16 36 56
60 44 24 60 12 24 28 60
