60 60 60 60 52 60 44 48
52 36 32 32 16 52 44 24
20 4 8 8 0 16 36 48
4 8 32 42 1 0 0 24
4 48 28 60 12 24 12 56
12 8 48 60 44 48 36 48
52 44 16 52 60 20 12 16
12 56 28 28 60 28 60 28
