52 60 52 36 48 36 32 48
20 44 24 28 12 24 20 28
28 60 60 36 40 32 0 48
44 48 52 7 48 4 8 24
52 12 16 4 0 8 56 60
20 36 8 16 20 52 44 48
28 20 44 24 12 8 40 24
60 28 60 44 40 56 60 60
