60 52 44 32 48 44 32 56
60 20 36 24 20 44 16 60
44 8 0 34 8 56 12 48
44 56 20 29 60 52 52 28
44 40 0 48 60 4 0 48
60 60 20 4 40 24 20 28
44 56 4 16 36 32 8 48
44 56 12 24 28 12 56 28
