52 36 48 36 40 40 56 52
4 16 28 20 52 60 52 28
20 4 40 8 0 40 16 52
20 4 40 59 12 32 0 16
28 20 52 36 48 20 12 16
36 16 28 4 24 4 48 28
12 0 32 8 40 0 24 60
60 12 24 60 60 12 56 60
