36 48 52 52 36 48 44 56
12 24 20 20 28 20 44 48
44 56 20 12 40 16 52 20
52 36 24 54 52 4 16 20
28 12 48 4 17 20 28 20
52 36 0 0 0 0 40 16
12 8 16 20 28 28 44 16
44 40 8 8 56 44 56 28
