60 60 44 48 52 60 60 52
44 40 56 12 24 44 32 16
44 48 60 46 48 44 8 24
36 0 48 60 4 57 60 52
4 16 20 36 24 44 56 20
28 12 8 0 48 60 60 28
60 60 52 28 20 44 48 60
44 40 24 60 28 60 12 56
