36 56 52 44 48 60 52 60
4 40 0 40 24 52 12 56
4 56 4 48 60 4 56 52
12 56 20 6 41 8 40 24
52 44 0 16 60 36 32 56
12 40 16 28 36 0 24 60
36 48 12 32 0 8 56 52
28 12 56 12 24 60 44 24
