60 44 40 56 44 56 52 60
52 36 48 52 60 44 16 60
28 28 4 24 36 32 8 48
60 36 24 46 9 0 40 16
60 4 32 32 56 4 48 20
52 20 20 4 40 24 12 24
12 0 8 0 48 52 44 48
60 12 40 24 12 8 40 24
