60 60 36 56 52 36 56 52
36 56 4 32 24 28 60 20
28 60 20 28 44 56 36 24
36 56 4 42 48 44 24 52
12 32 16 52 4 48 36 24
44 8 16 20 4 9 16 52
60 52 12 8 8 56 20 28
60 12 56 44 40 56 28 60
