44 56 60 44 56 52 44 48
52 52 36 48 52 4 56 20
12 16 12 8 8 16 52 20
44 16 60 54 52 12 16 20
60 12 56 4 9 56 28 20
60 52 44 16 52 44 32 16
52 4 56 12 0 32 24 20
28 12 40 56 28 12 40 24
