60 36 32 56 44 32 32 48
60 20 12 40 40 16 12 24
52 12 48 60 52 20 52 52
28 60 12 42 17 4 24 20
36 56 44 48 12 16 44 24
20 52 36 24 36 24 52 52
28 12 0 48 4 48 28 20
60 44 8 24 28 28 60 28
