44 56 52 52 52 44 48 52
44 40 16 12 16 52 28 20
52 36 16 54 12 0 32 24
20 4 16 4 32 0 8 48
28 12 24 12 25 28 36 16
44 40 48 44 32 48 4 16
60 36 24 36 16 12 24 28
44 24 60 28 28 44 56 60
