60 36 48 36 56 36 48 60
52 20 4 0 40 24 20 52
20 28 12 16 60 52 28 28
20 44 56 23 36 24 60 60
4 48 60 28 20 36 56 52
12 16 44 40 16 20 44 16
36 0 40 48 20 4 40 24
28 28 44 24 12 8 40 56
