60 52 52 52 60 36 56 52
44 24 28 12 40 24 44 24
44 56 46 32 40 48 60 52
60 36 48 4 32 8 56 28
52 12 8 8 17 52 44 56
28 52 60 60 20 4 32 48
44 24 52 36 24 20 12 16
44 56 12 24 60 28 44 24
