52 44 48 52 52 60 44 56
4 40 16 20 4 56 60 52
28 36 16 28 20 44 56 28
60 20 20 54 4 56 36 48
52 28 28 5 16 60 4 16
12 56 44 24 4 48 20 28
60 36 48 60 12 16 12 48
60 12 24 60 44 24 44 24
