44 56 44 48 52 52 36 48
36 48 52 12 16 20 20 28
28 4 16 52 28 28 28 52
44 8 16 6 48 44 40 24
52 60 4 8 17 60 60 52
4 40 16 52 12 48 36 16
4 56 20 20 60 20 12 24
12 40 24 12 56 12 40 56
