44 56 36 48 44 56 52 52
60 60 20 12 56 36 8 24
36 48 6 32 48 4 32 56
4 0 24 5 16 28 4 56
12 24 52 4 24 36 8 48
44 32 16 12 48 4 56 20
52 4 16 52 20 4 40 16
28 12 24 28 28 28 60 28
