44 56 44 32 48 44 48 52
52 52 52 12 0 48 12 24
12 24 6 48 28 20 52 60
44 40 24 4 48 28 28 60
44 32 40 0 25 36 48 52
36 8 48 4 40 16 4 16
4 40 16 4 32 16 12 16
12 56 12 24 12 24 44 24
