60 52 52 52 60 36 56 52
44 8 0 0 56 12 32 24
60 44 8 24 52 52 4 48
44 56 52 47 0 8 0 24
44 48 28 36 24 44 0 56
36 0 48 4 56 36 8 56
12 0 16 4 32 0 48 52
60 28 12 8 8 24 28 28
