36 40 48 36 32 32 32 56
28 44 16 12 0 0 24 52
52 60 4 56 28 4 32 16
28 52 20 38 57 12 0 24
60 28 12 8 40 48 28 52
60 52 44 56 52 4 32 16
36 0 48 44 0 16 12 24
12 24 12 56 28 28 44 56
