44 48 36 56 52 60 36 56
44 8 0 56 20 36 16 52
44 56 4 40 16 28 12 16
36 40 24 54 28 44 56 20
20 44 40 1 48 36 40 24
4 56 44 0 16 20 36 48
28 36 48 4 8 0 8 24
44 8 8 24 60 12 40 56
