52 60 44 40 56 44 32 56
4 40 56 36 56 52 4 48
28 44 32 8 56 20 28 20
44 48 4 50 60 20 36 16
52 4 16 5 48 4 8 24
28 20 12 16 28 28 44 48
44 24 52 12 40 40 40 16
44 40 24 60 60 44 56 28
