60 60 36 48 36 48 36 48
52 36 16 28 12 24 4 16
4 24 12 40 48 60 28 20
12 40 48 54 28 60 52 28
52 44 8 9 48 36 8 48
28 60 36 40 8 8 40 16
52 36 16 36 32 40 32 24
28 28 12 24 28 60 28 60
