44 48 36 40 32 32 56 60
36 16 20 60 28 4 56 60
28 12 16 60 52 12 40 48
44 40 16 54 20 60 36 16
52 44 16 4 17 44 8 16
12 40 8 16 12 48 36 16
44 48 44 16 52 4 0 24
60 12 56 12 8 8 8 56
