52 44 32 40 40 40 40 56
6 32 24 60 60 44 40 56
28 4 32 40 32 48 44 56
44 24 4 32 24 20 36 56
36 56 28 13 40 24 28 60
20 44 56 44 56 44 48 60
20 52 36 48 60 60 20 52
12 24 12 8 40 56 12 24
