60 44 56 60 36 32 40 56
44 32 48 44 24 4 56 52
60 20 6 32 32 0 48 20
60 12 0 17 28 12 24 28
44 56 28 28 36 40 32 56
60 60 60 36 8 48 20 52
36 40 56 20 52 28 28 20
12 40 40 8 8 56 44 24
