52 44 32 48 36 56 52 52
28 36 8 24 4 40 16 20
52 20 36 56 4 40 8 24
12 24 6 57 20 52 36 56
52 60 4 40 16 28 20 52
20 60 12 32 0 56 12 16
12 56 60 20 20 52 44 16
44 56 44 8 24 28 60 28
