36 48 60 52 60 60 60 60
28 4 48 28 60 60 36 56
52 12 0 56 60 36 16 52
12 32 16 38 32 8 8 24
44 16 12 9 16 44 48 52
44 24 60 36 0 48 4 16
44 32 48 12 24 4 16 28
60 12 8 56 44 24 12 56
