60 60 60 60 52 44 48 52
36 32 48 52 12 40 16 28
28 28 28 28 36 32 16 52
52 36 40 50 28 12 0 16
4 24 52 4 33 40 0 16
4 56 28 28 4 32 16 20
4 32 48 52 28 28 28 20
12 8 8 24 44 40 40 24
