60 60 52 52 60 52 52 52
44 40 8 24 60 28 28 28
36 48 52 54 36 40 40 48
12 0 24 13 16 44 48 20
44 0 32 48 4 40 24 20
44 24 4 24 12 32 40 24
52 36 24 52 44 0 32 56
12 24 60 28 44 8 8 56
