36 40 40 48 52 36 40 56
20 52 44 24 28 28 52 60
12 8 32 32 48 36 24 60
36 56 4 11 8 0 40 56
4 32 16 36 56 4 32 56
12 24 4 0 48 28 4 48
44 56 20 20 28 60 20 20
60 60 12 8 40 56 28 28
