44 56 36 32 40 40 48 52
44 56 20 20 52 44 0 16
60 36 0 8 0 40 0 16
52 12 8 35 16 36 24 20
20 36 40 0 24 28 36 24
12 8 48 4 56 60 4 48
36 32 8 16 36 48 28 20
28 12 40 24 28 28 60 28
