36 32 56 60 52 60 36 48
12 0 56 52 4 48 20 28
36 8 56 4 24 12 16 60
28 36 48 15 40 40 8 48
44 24 4 48 44 56 60 20
44 48 12 16 60 52 36 16
60 20 52 28 36 16 4 24
60 28 28 60 28 12 24 60
