44 40 48 52 36 56 36 48
36 40 16 4 16 44 8 24
20 60 4 24 20 36 48 60
4 56 28 38 17 28 4 56
20 44 40 8 0 48 4 48
20 36 40 48 4 8 24 28
28 20 52 20 28 52 60 60
60 28 12 24 60 12 56 60
