36 32 40 48 36 56 44 48
28 20 52 12 0 32 40 24
60 20 28 52 20 12 32 56
60 12 50 12 24 36 8 56
36 48 4 48 44 8 32 56
12 8 16 5 48 44 16 60
52 60 28 12 0 40 0 56
28 60 60 60 12 40 24 60
