44 56 44 40 32 48 52 52
60 52 52 44 24 20 12 24
52 20 28 44 56 4 48 60
28 12 50 44 48 12 16 52
36 48 4 57 12 48 28 28
20 28 28 52 60 4 32 56
12 32 40 0 48 12 0 48
44 8 40 24 12 40 8 24
