36 48 36 48 52 36 56 52
12 16 28 12 8 8 40 24
38 8 32 56 52 52 60 52
4 48 4 32 8 0 40 24
28 4 8 17 60 12 56 60
52 12 32 16 52 60 44 48
4 32 0 0 24 60 52 20
12 8 8 8 56 60 12 24
