60 52 52 52 36 40 56 60
36 0 24 28 28 36 56 52
20 6 32 56 44 24 60 28
20 28 4 32 40 48 60 60
20 52 4 17 44 8 32 56
20 28 20 20 44 56 12 48
4 32 16 20 60 60 44 16
12 8 24 28 60 44 40 24
