52 60 44 40 32 40 48 52
28 60 60 52 20 52 4 24
44 56 44 8 8 24 28 52
60 60 60 54 52 36 32 16
36 56 60 29 4 24 4 16
28 44 32 48 4 56 28 20
52 52 12 8 24 36 48 20
12 8 40 40 40 24 28 28
