60 36 32 48 60 52 52 52
60 28 4 16 60 4 24 28
44 32 24 12 48 20 44 48
52 4 40 35 24 12 48 28
4 0 40 24 36 32 16 60
20 28 52 60 4 16 20 52
28 60 4 48 4 24 12 24
44 56 12 8 8 56 60 60
