36 48 60 60 36 40 40 56
20 20 52 44 16 44 48 52
20 28 28 52 4 48 12 16
28 54 60 20 12 24 60 28
60 4 48 12 48 52 44 48
60 20 4 32 16 4 32 16
60 12 24 21 4 24 4 24
44 40 40 24 28 60 12 56
