60 52 52 60 36 40 40 56
44 8 24 44 16 36 56 52
36 56 36 56 20 20 44 16
4 40 0 50 28 28 36 16
4 56 20 13 40 32 8 24
20 44 24 44 40 8 48 60
12 32 40 40 56 36 16 60
60 12 56 44 56 28 12 56
