60 44 40 48 44 40 48 52
60 36 32 24 52 44 24 20
52 12 8 34 8 48 60 28
12 32 48 21 52 4 56 60
44 0 8 0 0 8 48 60
44 8 48 4 8 40 16 52
36 48 4 8 40 32 16 20
28 28 28 44 56 12 24 28
