44 32 56 52 60 44 32 56
52 20 60 20 52 36 0 56
28 12 40 24 12 0 16 60
36 56 46 32 32 16 4 48
12 48 60 29 12 0 8 24
44 0 40 56 52 28 44 48
44 8 40 40 16 52 44 16
44 56 60 44 24 28 44 24
