36 32 32 32 32 48 44 48
12 0 0 8 24 28 44 16
36 0 24 36 32 56 52 20
20 12 48 22 4 49 4 24
4 48 12 8 24 20 4 56
28 12 56 60 44 24 4 48
44 48 60 60 44 40 24 28
44 24 60 44 56 44 40 56
