36 48 60 44 56 44 56 60
4 8 40 32 32 40 40 48
12 40 40 8 0 48 60 28
36 40 40 59 20 12 40 56
20 36 56 44 0 32 48 52
12 24 60 44 16 20 28 20
44 48 44 56 12 16 52 28
44 8 40 40 40 24 28 60
