52 60 44 40 32 56 44 48
4 56 44 32 24 44 56 20
28 52 60 4 32 40 32 24
44 0 32 27 20 44 24 52
60 28 28 36 0 40 32 24
44 56 44 16 28 52 4 56
44 40 56 4 32 16 4 56
60 44 56 12 24 12 8 56
