52 52 60 44 40 56 52 52
28 4 32 32 32 32 24 28
36 16 12 16 12 0 56 60
12 0 48 6 57 4 40 56
52 28 28 20 44 8 40 48
28 44 32 8 32 40 40 16
60 36 16 52 4 40 56 20
44 8 24 12 8 40 40 24
