44 48 60 36 32 32 40 48
44 8 32 8 16 28 44 16
52 60 12 48 20 44 48 28
4 32 42 9 16 36 24 60
4 8 32 48 28 12 56 52
28 44 8 16 52 44 32 24
52 60 60 12 16 36 24 52
12 56 60 44 24 12 40 24
