60 44 40 48 60 60 44 56
52 44 56 4 32 32 40 56
4 48 60 28 28 12 40 56
4 8 42 33 56 52 44 56
12 48 52 28 44 24 36 56
52 4 8 48 52 52 4 56
20 12 56 28 4 8 0 56
12 40 40 40 8 56 28 60
