52 52 44 32 32 32 40 56
12 16 44 8 16 28 44 48
60 28 44 40 0 40 48 28
60 52 44 50 28 52 12 48
60 28 60 4 41 0 32 16
36 40 48 20 60 20 20 20
28 36 0 8 48 20 4 24
44 8 24 44 24 12 8 56
