60 44 48 44 56 36 48 52
52 52 12 32 56 4 8 24
28 20 54 4 32 24 60 60
36 16 4 1 0 40 40 48
28 20 12 8 0 40 48 28
60 4 56 36 8 56 12 48
52 28 44 16 52 60 44 16
12 40 40 24 12 40 56 28
