60 44 56 60 36 56 44 48
44 32 40 56 12 40 48 20
36 8 40 42 48 60 4 24
4 56 52 36 25 60 4 56
20 52 28 12 40 56 28 60
20 4 32 56 44 56 52 60
4 16 20 44 40 40 8 48
12 24 12 40 40 56 44 24
