52 52 44 56 36 40 56 52
28 12 56 52 20 44 40 24
60 60 60 28 12 32 56 60
44 40 48 46 48 12 32 56
60 60 12 41 16 44 8 56
60 52 36 48 12 48 44 48
52 28 12 16 36 0 56 28
28 44 56 12 24 12 56 60
