36 48 44 32 40 48 60 52
28 20 36 16 36 24 44 16
60 28 4 8 24 36 32 24
52 44 16 38 32 24 20 60
4 48 20 28 5 56 4 48
4 24 4 32 16 36 8 16
20 36 16 20 20 4 40 24
12 8 8 8 8 24 60 60
