60 60 60 44 32 48 44 56
60 36 40 48 12 24 52 60
44 0 50 12 56 60 12 56
60 28 4 33 40 40 40 48
52 36 24 28 60 60 60 20
20 4 32 56 44 48 60 28
20 12 8 56 52 12 56 60
12 40 56 44 24 44 40 56
