60 44 56 52 52 36 32 56
44 48 44 0 0 8 8 48
44 16 44 24 28 52 52 28
60 20 52 46 33 0 16 60
52 12 16 52 20 4 8 48
20 36 8 8 8 8 56 28
20 12 32 40 48 52 60 52
12 56 12 40 8 24 44 24
