60 60 36 56 60 52 60 60
60 52 12 56 60 20 36 48
36 16 38 48 60 28 28 20
28 20 12 25 52 44 56 28
52 28 44 32 0 40 40 56
28 52 36 16 28 44 56 60
52 12 16 28 60 60 52 52
12 40 24 44 56 60 12 24
