60 52 36 32 32 32 56 60
60 28 20 12 0 16 52 60
36 32 0 48 12 8 16 52
20 12 16 23 44 40 8 16
20 60 28 20 44 56 60 28
28 44 48 20 52 44 40 56
52 44 0 0 0 56 52 52
28 60 28 12 24 60 12 24
