52 60 36 40 56 44 48 52
28 36 8 56 52 36 24 20
60 20 38 48 12 0 56 20
52 20 20 13 48 4 40 16
28 28 4 32 24 12 40 24
44 56 20 12 40 48 36 48
52 52 20 36 56 12 0 16
28 28 28 12 40 40 8 24
