52 52 44 56 36 48 44 48
20 28 44 56 4 0 32 16
12 48 44 56 4 0 24 28
44 0 56 38 24 20 60 52
36 0 48 13 56 20 36 24
4 24 4 48 44 0 24 52
4 48 12 8 56 20 44 24
28 12 56 60 44 24 60 60
