44 32 48 60 52 36 56 60
52 28 20 44 8 0 32 48
20 36 24 54 60 12 8 24
4 0 56 4 33 48 44 56
4 0 40 24 20 28 60 60
28 20 60 60 20 36 56 52
60 12 40 48 28 28 44 16
60 44 56 28 60 60 44 24
