44 56 44 32 40 48 36 56
44 56 52 4 56 4 8 56
44 32 8 0 48 28 52 60
44 8 42 25 20 60 4 48
60 36 32 48 12 40 24 28
60 4 0 0 40 40 40 48
52 12 8 0 32 32 32 16
28 60 60 12 8 24 28 28
