52 44 56 60 36 48 52 52
28 52 44 32 24 20 20 20
44 8 32 24 36 24 4 24
60 60 28 54 12 56 28 60
60 52 52 5 56 36 56 52
60 28 20 20 44 0 32 16
52 36 16 12 40 16 20 20
28 28 28 44 56 28 12 24
