36 56 44 56 52 52 44 56
12 56 36 56 20 4 32 56
44 56 20 36 16 20 20 52
44 40 16 23 12 24 4 24
52 52 12 0 56 36 0 48
12 0 40 24 60 28 28 28
44 16 44 32 56 60 36 48
60 28 60 12 40 56 28 28
