44 40 48 52 36 32 56 60
36 48 12 0 8 24 52 52
4 8 50 28 36 32 8 16
28 60 4 49 28 4 40 16
60 44 0 8 40 8 40 16
44 56 28 52 44 40 40 24
60 36 56 28 52 36 32 56
60 12 56 44 24 12 24 60
