     0    36     4    56    20     8    28    48
    28    46    16    12    32    44    48    36
    24    52    20    24     4    20    36    32
    20    44    24     0    56     0    28     4
     4     4    12    24    52    20     4    20
    44    36    56    44    20    60    36    60
    48    12    36     4    20    16    16    28
    12     0    48    16    40    56    48    61