    60    60    44    56    44    56    44    56
    36    56    60    36    56    60    52    52
    12    56    52    28    52    60    12    24
    36    48    12    32     8    40    32    48
    20    12    40    24    47    48    28    28
    20    36    48    52    36    16    60    52
    12    24    28    20     4    24    36    24
    60    60    44    24    28    60    28    60