    36    56    44    48    52    52    52    52
    28    52    52    12    16     4     8    24
    60    20    20    54    12     0    56    52
    36    16    12    17    52     4    56    20
    12     0    32     8    24    12    32    24
    52    12     8    32    32    32     0    56
     4    32    56    20    20    20    12    48
    28    28    60    12    24    12    56    28
